 --- --- --- --- --- --- --- --- --- 
| v   ?   ?   ?   ?   ?   ?   ?   ? |
                                     
| ?   ?   ?   ?   ?   ?   ?   ?   ? |
                                     
| ?   ?   ?   ?   ?   ?   ?   ?   ? |
                                     
| ?   ?   ?   ?   ?   ?   ?   ?   ? |
                                     
| ?   ?   ?   ?   ?   ?   ?   ?   ? |
 --- --- --- --- --- --- --- --- --- 